111111111111111
1E00000C0000001
10000C0000C0001
111000110000011
111P000000C0001
111111111111111